###
#o#####
#oo   #
# @@@A#
#    ##
######
  