######
#oooo####
#  @##  #
# @@    #
#A@ #   #
##  #####
 ####